####################
#                  #
# BBBBBBBBBBBBB### #
# BB               #
# #BBBBBBBBBBBB### #
#                  #
# BBBBB     BBBB## #
# #      # #     # #
# #####  #       # #
#        # #     # #
# BBBB    BBBBB ## #
#  B        BBB    #
#                  #
# ### #### #### ## #
###    #     #   # #
# #### ### #### ## #
# #    #         ###
# ## BB       #### #
#         H   F    #
####################