####################
#H  BBBB#BVBBBBBBBV#
#   BBBBBBBB#BB#BBB#
#BBBBBBB#VVVBBB  BB#
#VB  BBBBBBB#BB#BBV#
#BBB#BBB#VVVBBB  BB#
#BB  BBBBBBB#BB#BBB#
#VBB#BBB#BBBBBB  BV#
#BB  VBBBBBB#BV#BBB#
#BBB#BBB#BBBBBB  BB#
#VB  BBBBVVV#BB#BBV#
#BBB#BBB#BBBBBB  BB#
#BB  BBBBBBB#BB#BBB#
#BBB#BBB#BBBBBB  BB#
#BB  BBBBVVV#BB#BBB#
#BBB#VBB#BBBBBV  BB#
#BBBBBBB#VVV#BB#BBB#
#VBB#BBBBBBBBBBB  V#
#VB  BBB#BVB#BBB  F#
####################