####################
#H  BBBB#BBBBBBBBBB#
#   BBBBBBBB#BB#BBB#
#BBBBBBB#BBBBBB  BB#
#BB  BBBBBBB#BB#BBB#
#BBB#BBB#BBBBBB  BB#
#BB  BBBBBBB#BB#BBB#
#BBB#BBB#BBBBBB  BB#
#BB  BBBBBBB#BB#BBB#
#BBB#BBB#BBBBBB  BB#
#BB  BBBBBBB#BB#BBB#
#BBB#BBB#BBBBBB  BB#
#BB  BBBBBBB#BB#BBB#
#BBB#BBB#BBBBBB  BB#
#BB  BBBBBBB#BB#BBB#
#BBB#BBb#BBBBBB  BB#
#BBBBBBB#BBB#BB#BBB#
#BBB#BBBBBBBBBBB   #
#BB  BBB#BBB#BBB  F#
####################