####################
#                  #
# BBBBBBBBBBBBB### #
# BB               #
# #BBVVVBBBBBBB### #
#                  #
#               ## #
# #      # #     # #
# #####  #       # #
#        # #     # #
# BBBB          ## #
#  B        BBB    #
#                  #
#                  #
###    #     #   # #
#                  #
# #    #         ###
# ## BB       #### #
#         H   F    #
####################